1111111111
1001001001
1000000001
1001000001
1000011111
10000000P1
1010100011
1101001011
11C00010E1
1111111111
